NO ./textures/north.xpm
SO ./textures/south.xpm
WE ./textures/west.xpm
EA ./textures/east.xpm

F 255,256,0
C 100,100,100,100

11111
10N01
10001
11111
