NO ./textures/north.xpm
SO ./textures/south.xpm
WE ./textures/west.xpm
// EA ./textures/east.xpm  <- Missing East texture

F 220,100,0
C 0,150,255

11111111
100000N1
10100101
11111111
